NO ./textures/n.xpm
SO ./textures/s.xpm
EA ./textures/e.xpm
WE ./textures/e.xpm

F 256,255,255
C -2,0,1


1111111111111111111111111111
1111111111111111111111111111
1100000000000000000000000011
1100000000000000000000000011
1100000000000000000000000011
1100001000000000000000000011
1100000000000000000000000011
1100000000000001100000000011
11000000011100000000000E0011
1100000000000000000000000011
1100000000000000000000000011
1100000000000000000000000011
1100000010000000100000000011
1100000000000000000000000011
1100000000000000000000000011
1111111111111111111111111111
1111111111111111111111111111