NO ./path_to_.the_north_texture.xpm
SO  ./path_to_the_south_texture.xpm
EA ./path_to_the_east_texture.xpm
WE ./path_to_the_west_texture.xpm

F 0,220,0
C 225,3,0

11111111111
10111011111
1 11101N11
1111111111
11111111111
       1