




NO ./path_to_.the_north_texture.xpm
SO  ./path_to_the_south_texture.xpm
EA ./path_to_the_east_texture.xpm
WE ./path_to_the_west_texture.xpm

F 0,220,0
C 225,3,0


1111111111111111111111
10S0000000000000000001
1000011111111111100001
100001          100001
100001          100001
100001          100001
100001          100001
1000011111111111100001
1000000000000000000001
1111111111111111111111
1111111111111111111111
1000000000000000000001
1000000000000000000001
1000000000000000000101
1111111111111111111111