NO ./textures/n.xpm
SO ./textures/s.xpm
EA ./textures/e.xpm
WE ./textures/pl.xpm

C 135,206,235
F 0,128,0

1111111111111
1000000000001
1000000000001
1000S00000001
1000000000001
1111111111111