




NO ./path_to_.the_north_texture.xpm
SO  ./path_to_the_south_texture.xpm
EA ./path_to_the_east_texture.xpm
WE ./path_to_the_west_texture.xpm

F 0,220,0
C 225,30,0


1111111111111111111111111
11000000000000S111111111
11111111111111       1111
1111111111111111111111111