NO ./textures/n.xpm
SO ./textures/s.xpm
EA ./textures/e.xpm
WE ./textures/e.xpm

C -2,0,1
F 2 ,5, 1

11111111111111111111111111
10000000000000000000000001
10000000000000000000000001
100000N0000000000000000001
10000100000000000000000001
10000000000000000000000001
10000000000000110000000001
10000000111000000000000001
10000000000000000000000001
10000000000000000000000001
10000000000000000000000001
10000001000000010000000001
10000000000000000000000001
10000000000000000000000001
11111111111111111111111111