NO ./textures/n.xpm
SO ./textures/s.xpm
EA ./textures/e.xpm
WE ./textures/f.xpm

F 0,255,0
C 0,1,255

111111111111111
100000000000001
100000000000001
100000000000001
100000S00000001
100000000000001
100000000000001
100000000000001
100000000000001
111111111111111