NO ./textures/n.xpm
SO ./textures/s.xpm
EA ./textures/e.xpm
WE ./textures/pl.xpm

C 135,206,235
F 0,128,0

111111111
100000001
100000001
1000S0001
100000001
100000001
100000001
100000001
111111111