




NO ./path_to_.the_north_texture
SO        ./path_to_the_south_texture
EA ./path_to_the_east_texture
WE ./path_to_the_west_texture

F 0,220,100
C 225,30,0


1111111
1000001
1S00 01
1000001
1111111