




NO ./path_to_.the_north_texture.xpm
SO  ./path_to_the_south_texture.xpm
EA ./path_to_the_east_texture.xpm
WE ./path_to_the_west_texture.xpm

F 0,220,0
C 225,30,0

1111111111
1111111111
1111111111
11111N1111
1000000001
1111111111


11111111111111111111111111111111111111111111
101
111
       11111111111
111111110000000001
       100000000011111111
100000000000000001
111111111111101111
11111111111111111