NO ./textures/n.xpm
SO ./textures/s.xpm
EA ./textures/e.xpm
WE ./textures/pl.xpm

C 135,206,235
F 0,128,0

1111111111111111111111111
1111111111111111111111111
1100000000000000000000011
1100000000000000000000011
11000S0000000000000000011
1100000000000000000000011
1111111111111111111111111
1111111111111111111111111