




NO ./path_to_.the_north_texture.xpm
SO  ./path_to_the_south_texture.xpm
EA ./path_to_the_east_texture.xpm
WE ./path_to_the_west_texture.xpm

F 0,220,0
C 225,30,0

1111111
1000001
1010001
1111111
0
111111111111
100000000001
10S000000001
111111111111

