NO ./path_to_the_north_texture.xpm
SO ./path_to_the_south_texture.xpm
EA ./path_to_the_east_texture.xpm
WE ./path_to_the_west_texture.xpm

F 256,255,255
C -2,0,1


1111111111111111111111111
1000000000110000000000001
1011000001110000000000001
100100000000000000000000111111111
1011111111011000001110000000000001
100000000011000001110111111111111
11110111111111011100000010001
11110111111111011101010010001
11000000110101011100000010001
10000000000000001100000010001
10000000000000001101010010001
1100000111010101111101111N00111
11110111 1110101 101111010001
11111111 1111111 111111011111