NO 			./textures/star.xpm
NO 			./textures/b.xpm
NO		 ./textures/bozaka.xpm
NO ./textures/fanina.xpm

F 0,0,0
F 0,0,0

        1111111111111111111111111111
        1000000000110001010000001001
        1011000011100001110000011111
        1001000000000000000000001
111111111011000001110000000000001
100000000011000S001110111111111111
11110111111111011100000010001
11110111111111011101010010001
11000000110101011100000010001
1000000000000000110000010001
10000000000000001101010010001
1100000111010101111101111000111
11110111 1110101 10111101001
1111111111111111111111111111
