NO ./textures/n.xpm
SO ./textures/s.xpm
EA ./textures/e.xpm
WE ./textures/hah.xpm

C 135,206,235
F 0,128,0

11111111111111111111111
10000000000000000000001
10000000000000000000001
1000S000000000000000001
10000000000000000000001
11111111111111111111111