NO ./path_to_.the_north_texture.xpm
SO  ./path_to_the_south_texture.xpm
EA ./path_to_the_east_texture.xpm
WE ./path_to_the_west_texture.xpm

F 0,220,0
C 225,3,0

11111111111
1011111111111111111
10000000000000000S1
1011111111111111111
1111111111111111111