NO ./textures/n.xpm
SO ./textures/s.xpm
EA ./textures/e.xpm
WE ./textures/f.xpm

F 256,255,255
C -2,0,1


11111111111111111111111111
10000000000000000000000001
10000000000000000000000001
10000000000000000000000001
10000100000000000000000001
10000000000000000000000001
10000000000000100000000001
100000E0000000010000000001
10000000111000000000000001
10000000000000000000000001
10000000000000000000000001
10000001000000010000000001
10000000000000000000000001
10000000000000000000000001
11111111111111111111111111