NO ./textures/n.xpm
SO ./textures/s.xpm
EA ./textures/e.xpm
WE ./textures/e.xpe

C -2,0,1


11111111111111111111111111
10000000000000000000000001
10000000000000000000000001
10000000000000000000000001
10000100000000000000000001
10000000000000000000000001
10000000000000110000000001
10000000111000000000000001
10000000000000000000000001
10000000000000000000000001
10000000000000000000000001
10000001000000010000000001
10000000000000000000000001
10000000000000000000000001
111111111111111111111111