NO ./path_to_the_north_texture.xpm
SO ./path_to_the_south_texture.xpm
EA ./path_to_the_east_texture.xpm
WE ./path_to_the_west_texture.xpm

F 256,255,255
C -2,0,1


1111111111111111
1000000000000001
1000001000000001
1000000000000001
1000000000000001
1000000000000001
100000001000S001
1000000000000001
1000000000000001
1000000010000001
11111111 111111

111
101
111