NO ./textures/star.xpm
SO ./textures/star.xpm
EA ./textures/star.xpm
WE ./textures/star.xpm

C 0,0,0
F 0,0,0

        1111111111111111111111111
        1000000000110000000000001
        101100001110000000000001                         
        1001000000000000000000001
111111111011000001110000000000001
10000000001100W001110111111111111
11110111111111011100000010001
11110111111111011101010010001
11000000110101011100000010001
1000000000000000110000010001
10000000000000001101010010001
1100000111010101111101111000111
11110111 1110101 10111101001
11111111 1111111 11111111111