NO ./textures/n.xpm
SO ./textures/s.xpm
EA ./textures/e.xpm
WE ./textures/f.xpm

C 135,206,235
F 0,128,0

111111111111111
100000000000001
100000000000001
100000000000001
100000E10000001
100000000000001
100000000000001
100000000000001
100000000000001
111111111111111