NO 			./textures/star.xpm
NO 			./textures/b.xpm
NO		 ./textures/bozaka.xpm
NO ./textures/fanina.xpm

F 0,0,0
C 0,0,0

1111110S11111111111111111111
