NO ./textures/n.xpm
SO ./textures/s.xpm
EA ./textures/e.xpm
WE ./textures/e.xpm

C -2,0,1
F 2 ,5, 1

11111111111111111111111111111111
11111111111111111111111111111111
11111111111111111111111111111111
11111111111111S00111111111111111
11111111111111111111111111111111