NO ./textures/neon.xpm
SO ./textures/neon.xpm
EA ./textures/neon.xpm
WE ./textures/neon.xpm

C -2,0,1
F 2,5,1

1111111111111111111111111
100000000000000000000001
100000000000000100000001
100000000000010000000001
100000000000000000000001
100000000000S00000000001
1000000001000000000000001
100000000000000000000001
100000000000000011000001
100000000000000000000001
111111111111111111111111